NO ./texture/1.xpm
SO ./texture/door_o.xpm
WE ./texture/enemy.xpm
EA ./texture/pac_wright.xpm
F 220,100,0
C 255,30,0


        1111111111111111111111111
        1000000000110000000000001
        1011000001110000000000001
        1001000000000000000000001
111111111011000001110000000000001
100000000011000001110111111111111
11110111111111011100000010001          1
11110111111111011101010010001          1     
11000000110101011100000010001         1E1
10000000000000001100000010001          1  1
10000000000000001101010010001 111      1
110000011101010111110111100011101
11110111 1110101 101111010001 111
11111111 1111111 111111111111