EA ./texture/redbrick.xpm
WE ./texture/bluestone.xpm
NO ./texture/eagle.xpm
SO ./texture/greystone.xpm
F 154,154,154
C 92,92,92

111111111111111
100000000000001
100000010000001
100000000000001
1001000N0001001
100000000000001
100000010000001
100000000000001
111111111111111
