EA ./texture/redbrick.xpm
SO ./texture/bluestone.xpm
WE ./texture/eagle.xpm
NO ./texture/greystone.xpm
F 154,154,154
C 92,92,92

         11111111111111111111111
        10000000001100000000000N1
        1011000001110000000000001
        1001000000000000000000001
111111111011000001110000000000001
10000000001100000111011111111111 
11110111111111011100000010001
11110111111111011101010010001
11000000110101011100000010001
10000000000000001100000010001
10010000000000001101010010001
1100000111010101111101111000111
11110111 1110101 101111010001
11111111 1111111 111111111111