WE ./textures/walls_cf/mossy.png
SO ./textures/walls_cf/me.png
C 255,255,255
F 154,154,154
EA ./textures/walls_cf/eagle.png
NO ./textures/walls_cf/wood.png
 11111
1S00101
1001001
1010001
 11111
