EA ./textures/redbrick.xpm
WE ./textures/bluestone.xpm
NO ./textures/eagle.xpm
SO ./textures/greystone.xpm
F 154,154,154
C 92,92,92

        1111111111111111111111111
        1000000000110000000000001
        1011000001100000000000001
        1001000000000000000000001
111111111011000001110000000000001
100000000011000001110111111111111
11110111111111011100000010001
11110111111111011101010010001
110000001101010111000000000011111111111111111111111111111
100000000000000011000000000000000000000000000000000000001
100000000000000011010100000011111111111111011111111111111
11000001110101011111011110S0111          101
11110111 1110101 100011000001            101
11110111111101111101111011111            101
1000000000110000000000001                101 
1011000001100000000000001                101
10010000000000000000000011111111111111111101111111111111111
11111111101100000111000000000000000000000000000000000000001
10000000001100000111011111111111111111111111111111111111101
11110111111111011100000010001                           101
11110111111111011101010010001                           101
11000000110101011100000000001111111111111111111111111111101
10000000000000001100000000000000000000000000000000000000001
10000000000000001101010000001111111111111111111111111111111
1100000111010101111101111000111
11110111 1110101 101111010001
11111111 1111111 111111111111
