EA ./texture/redbrick.xpm
WE ./texture/bluestone.xpm
NO ./texture/eagle.xpm
SO ./texture/greystone.xpm
F 154,154,154
C 92,92,92

        1111111111111111111111111
        1000000000110000000000001
        1011000001100000000000001
        1001000000000000000000001
111111111011000001110000000000001
100000000011000001110111111111111
11110111111111011100000010001
11110111111111011101010010001
110000001101010111000000000011111111111111111111111111111
100000000000000011000000000000000000000000000000000000001
100000000000000011010100000011111111111111111111111111111
11000001110101011111011110N0111
11110111 1110101 101111010001
11111111 1111111 111111111111
