WE ./textures/walls_cf/mossy.png
SO ./textures/walls_cf/redbrick.png
EA ./textures/walls_cf/eagle.png
NO ./textures/walls_cf/wood.png
C 255,255,255
F 154,154,154

        111111111111111111111111
        1000000000110000000000001
        101100000111000000N000001
        1001000000000000000000001
111111111011000001110000000000001
10000000001100000111011111111111
11110111111111011100000010001
11110111111111011101010010001
11000000110101011100000010001
10000000000000001100000000001
10000000000000001101010010001
1100000111010101111101111000111
11110111 1110101 101111010001
11111111 1111111 111111111111
