EA ./textures/walls_cf/redbrick.png
WE ./textures/walls_cf/redbrick.png
NO ./textures/walls_cf/redbrick.png
SO ./textures/walls_cf/redbrick.png
F ./textures/walls_cf/purplestone.png
C ./textures/walls_cf/colorstone.png

        1111111111111111111111111
        1000000000110000000000001
        101100000111000M000000001
        100100M0000D00000000W0001
111111111M11000001110000000000001
1000000M001100000111D111111111111
11110111111111D11100000010001
1111D111111111011101010010001
11000000110101011100000010001
1000M0000000000011000000D0M01
10000000000000001101D10010001
11000001110101011111M1111000111
11110111 1110101 101111010001
11111111 1111111 111111111111