EA ./textures/walls_cf/redbrick.png
WE ./textures/walls_cf/redbrick.png
NO ./textures/walls_cf/redbrick.png
SO ./textures/walls_cf/redbrick.png
F ./textures/walls_cf/purplestone.png
C ./textures/walls_cf/colorstone.png

        1111111111111111111111111
        1000000000110000000000001
        1MM100000111000E000000001
        100100M000MD0000000000001
111111111M110000011100000M0000001
1000000M001100000111D111111111111
11110111111111D1110M000010001
1111D111111111011101010010001
11000000110101011100000010001
1000M0000000000011000000D0M01
100000M0000000001101D10010001
11000001110101011111M11110M0111
11110111 1110101 101111010001
11111111 1111111 111111111111