EA ./textures/walls_cf/redbrick.png
WE ./textures/walls_cf/redbrick.png
NO ./textures/walls_cf/redbrick.png
SO ./textures/walls_cf/redbrick.png
F ./textures/walls_cf/purplestone.png
C ./textures/walls_cf/colorstone.png

111111111111
100000000001
100001010001
100001E10001
100001010001
111111111111