EA ./textures/walls_cf/redbrick.png
WE ./textures/walls_cf/redbrick.png
NO ./textures/walls_cf/redbrick.png
SO ./textures/walls_cf/redbrick.png
F ./textures/walls_cf/purplestone.png
C ./textures/walls_cf/colorstone.png

        1111111111111111111111111
        1000000000110000000000001
        1011000001100000E01000001
        100100000000000000D000001
111111111011000001110000001000001
111111111111111111111111111111111111
