EA ./textures/walls_cf/greystone.png
WE ./textures/walls_cf/redbrick.png
NO ./textures/walls_cf/redbrick.png
SO ./textures/walls_cf/redbrick.png
F ./textures/walls_cf/purplestone.png
C ./textures/walls_cf/colorstone.png

111111111111111111111111111111111
1000000000000000W0000000000000001
100000000000000000110000000000001
1000000000000000M1MD0000000000001
100000000000000M00110000000000001
10000000000000M000D00000010000001
1000000000000M0000100000100000001
100000000000M00000000000000000001
111111111111111111111111111111111
